 R          1366 768  
        NO           ./textures/Doom.xpm
SO         ./textures/Wolf.xpm
WE ./textures/Catacomb.xpm
               EA ./textures/Blackstone.xpm
S    ./textures/tree.xpm
F   72,56,24
C 17, 55, 99
        1111111111111111111111111
        1000020000110000000000021
        1011000001110000002002001
        1001000000000000000000021
111111111011000001110000111111001
120000000011000001113111111111111
11110111111111011100000010001
11110111111111010001010100001
11000000110101010000000300001
10002222222200001000000100001
10000000222000001000000110N01
1100000111010101111000011000111
11110111 1112101 100000010001
11111111 1111111 111111111111
